###########
#.........#
#.#....#..#
#.#....#..#
#.#..@....#
#..#...#..#
#...###...#
#....#....#
#....#....#
#.........#
###########